1 1 0 1 1
1 1 4 1 1
1 5 0 1 1
1 1 1 1 1
1 1 1 1 1